################
#L    @        #
#     X       G#
#   ooooo#######
#              #
#            ss#
#  C        #ss#
#      C    #ss#
#           #ss#
#          L#ss#
#      C    #ss#
#           #ss#
#  C        #dd#
#        ####dd#
#V C    C#ddddV#
################
